0,0,0,0,0,0,0,0,99,0,0,0,0,0,0,0,0,0,0,0,0,0,0,0,0,0,0,0,0,0,0,0,0,0,0,0,0,0,0,0,0,0,0,0,0,0,0,0,0,0,0,0,0,0,0,0,0,0,0,0,0,0,0,0,0,0,0,0,0,0,0,0,99
0,0,0,0,0,0,0,0,99,0,0,0,0,0,0,0,0,0,0,0,0,0,0,0,0,0,0,0,0,0,0,0,0,0,0,0,0,0,0,0,0,0,0,0,0,0,0,0,0,0,0,0,0,0,0,0,0,0,0,0,0,0,0,0,0,0,0,0,0,0,0,0,99
0,0,0,0,0,0,0,0,99,0,0,0,0,0,0,0,0,0,0,0,0,0,0,0,0,0,0,0,0,0,0,0,0,0,0,0,0,0,0,0,0,0,0,0,0,0,0,0,0,0,0,0,0,0,0,0,0,0,0,0,0,0,0,0,0,0,0,0,0,0,0,0,99
0,0,0,0,0,0,0,0,99,0,0,0,0,0,0,0,0,0,0,0,0,0,0,0,0,0,0,0,0,0,0,0,0,0,0,0,0,0,0,0,0,0,0,0,0,0,0,0,0,0,0,0,0,0,0,0,0,0,0,0,0,0,0,0,0,0,0,0,0,0,0,0,99
0,0,0,0,0,0,0,0,99,0,0,0,0,0,0,0,0,0,0,0,0,0,0,0,0,0,0,0,0,0,0,0,0,0,0,0,0,0,0,0,0,0,0,0,0,0,0,0,0,0,0,0,0,0,0,0,0,0,0,0,0,0,0,0,0,0,0,0,0,0,0,0,99
0,0,0,0,0,0,0,0,99,0,0,0,0,0,0,0,0,0,0,0,0,0,0,0,0,0,0,0,0,0,0,0,0,0,0,0,0,0,0,0,0,0,0,0,0,0,0,0,0,0,0,0,0,0,0,0,0,0,0,0,0,0,0,0,0,0,0,0,0,0,0,0,99
0,0,0,0,0,0,0,0,99,0,0,0,0,0,0,0,0,0,0,0,0,0,0,0,0,0,0,0,0,0,0,0,0,0,0,0,0,0,0,0,0,0,0,0,0,0,0,0,0,0,0,0,0,0,0,0,0,0,0,0,0,0,0,0,0,0,0,0,0,0,0,0,99
0,0,0,0,0,0,0,0,99,0,0,0,0,0,0,0,0,0,e01,e02,e03,e04,e05,e06,0,0,0,0,0,0,0,0,0,0,0,0,0,0,0,0,0,0,0,0,0,0,0,0,0,0,0,0,0,0,0,0,0,0,0,0,0,0,0,0,0,0,0,0,0,0,0,0,99,99,0,0,0,0,0,0,0,0,0,3,13,11,9,7,10,12,10,0,3,0,0,0,0,0,0,0,0,0,0,0,0,0,0,0,0,0,0,0,0,0,0,0,0,0,0,0,0,0,0,0,0,0,0,0,0,0,0,0,0,0,0,0
3,1,2,3,2,3,1,3,2,1,3,2,3,1,2,3,1,3,2,3,1,2,3,1,2,3,1,3,2,3,1,2,3,1,3,2,1,3,2,3,1,2,3,1,3,2,1,3,2,1,3,2,3,1,2,3,1,3,2,1,3,2,3,1,2,3,1,3,2,3,1,2,3,1,3,2,1,3,2,1,3,2,3,1,2,3,1,3,2,1,3,2,3,1,2,3,1,3,2,3,1,2,3,1,3,2,1,3,2,1,3,2,3,1,2,3,1,3,2,1,3,2,3,1,2,3,1,3,2,3,1,2,3,1,3,2,1,3,2,1,3,2,3,1,2,3
6,7,4,7,7,6,4,7,6,7,5,7,7,6,4,7,6,5,6,7,7,4,6,7,6,7,4,7,7,6,4,7,6,7,4,7,7,6,5,7,6,7,4,7,7,6,4,7,6,7,5,7,7,6,4,7,6,5,6,7,7,4,6,7,6,7,4,7,7,6,4,7,6,7,4,7,7,6,5,7,6,7,4,7,7,6,4,7,6,7,5,7,7,6,4,7,6,5,6,7,7,4,6,7,6,7,4,7,7,6,4,7,6,7,4,7,7,6,5,7,6,7,4,7,7,6,4,7,6,7,5,7,7,6,4,7,6,5,6,7,7,4,6,7,6,7
